111111111111111
100000000100001
100000001C00001
100010000100001
1001E0000000001
100010000000001
100000000000001
100000000111001
1000000001P0001
100000000111001
111111111111111