1111111
1C10001
1100001
1E000P1
1111111