1111111
1PE0011
10001C1
1111111