1111111111111111111111
10000P0000000000000001
1000001000C00000000001
100000000E000000C00001
1000000000000000000001
1000000000000000000001
1000000000000000000001
1000000000000000000001
1000000000000000000001
1111111111111111111111