1111111111111111111111
1000000000000000000001
1000001000C00000000001
1P0000000E000000C00001
1111111111111111111111