



      11111111111111111111111111111111111111111111111111
      10000C00100000000000000000000000000000000000000001
      10100000111000000000000000000000000000000000000001
      11111110001000000000000000000000000000000000000001
      10000000001000000000000000000000000000000000000001
      11111000000000000000000000000000000000000000000001
      10001111111000000000000000000000000000000000000001
      10000100000E00000000000000000010000000000000000001
      10000000000000000000000000000000000000000000000001
      1P000000000000000000000000000000000000000000000001
      11111111111111111111111111111111111111111111111111