111111111111111
10000C000000001
100000000000001
10000000000E001
100000000000001
1P0000000000001
111111111111111